FFFFFFFFFFFF*************************FFFFFFFFFFFFFFFFFFFFFFFFFFFFFFFFFFFFFFFFFFFFFFFFFFFFFFFFFFFFFFFFFFFFFFFFFFFFFFFFFFFFFF
FFFFFFFFFFFF*FFFFFFFFFFFFFFFFFFFFFFF*FFFFFFFFFFFFFFFFFFFFFFFFFFFFFFFFFFFFFFFFFFFFFFFFFFFFFFFFFFFFFFFFFFFFFFFFFFFFFFFFFFFFFF
FFFFFFFFFFFF*FFFFFFFFFFFFFFFFFFFFFFF*FFFFFFFFFFFFFFFFFFFFFFFFFFFFFFFFFFFFFFFFFFFFFFFFFFFFFFFFFFFFFFFFFFFFFFFFFFFFFFFFFFFFFF
FFFFFFFFFFFF*FFFFFF***********FFFFFF*FFFFFFFFFFFFFFFFFFFFFFFFFFFFFFFFFFFFFFFFFFFFFFFFFFFFFFFFFFFFFFFFFFFFFFFFFFFFFFFFFFFFFF
FFFFFFFFFFFF*FFFFFF*FFFFFFFFF*FFFFFF*FFFFFFFFFFFFFFFFFFFFFFFFFFFFFFFFFFFFFFFFFFFFFFFFFFFFFFFFFFFFFFFFFFFFFFFFFFFFFFFFFFFFFF
FFFFFFFFFFFF*FFFFFF*FFFFFFFFF*FFFFFF*FFFFFFFFFFFFFFFFFFFFFFFFFFFFFFFFFFFFFFFFFFFFFFFFFFFFFFFFFFFFFFFFFFFFFFFFFFFFFFFFFFFFFF
FFFFFFFFFFFF*FFFFFF*FFFFFFFFF*FFFFFF*FFFFFFFFFFFFFFFFFFFFFFFFFFFFFFFFFFFFFFFFFFFFFFFFFFFFFFFFFFFFFFFFFFFFFFFFFFFFFFFFFFFFFF
FFFFFFFFFFFF*FFFFFF*FFFFFFFFF*FFFFFF*FFFFFFFFFFFFFFFFFFFFFFFFFFFFFFFFFFFFFFFFFFFFFFFFFFFFFFFFFFFFFFFFFFFFFFFFFFFFFFFFFFFFFF
FFFFFFFFFFFF*FFFFFF*FFFFFFFFF*FFFFFF*FFFFFFFFFFFFFFFFFFFFFFFFFFFFFFFFFFFFFFFFFFFFFFFFFFFFFFFFFFFFFFFFFFFFFFFFFFFFFFFFFFFFFF
FFFFFFFFFFFF*FFFFFF*FFFFFFFFF*FFFFFF*FFFFFFFFFFFFFFFFFFFFFFFFFFFFFFFFFFFFFFFFFFFFFFFFFFFFFFFFFFFFFFFFFFFFFFFFFFFFFFFFFFFFFF
FFFFFFFFFFFF*FFFFFF*FFFFFFFFF*FFFFFF*FFFFFFFFFFFFFFFFFFFFFFFFFFFFFFFFFFFFFFFFFFFFFFFFFFFFFFFFFFFFFFFFFFFFFFFFFFFFFFFFFFFFFF
FFFFFFFFFFFF*FFFFFF*FFFFFFFFF*FFFFFF*FFFFFFFFFFFFFFFFFFFFFFFFFFFFFFFFFFFFFFFFFFFFFF|*************************************FF
FFFFFFFFFFFF*FFFFFF*FFFFFFFFF*FFFFFF*FFFFFFFFFFFFFFFFFFFFFFFFFFFFFFFFFFFFFFFFFFFFFF|FFFFFFFFFFFFFFFFFFFFFFFFFFFFFFFFFFFF*FF
FFFFFFFFFFFF*FFFFFF*FFFFFFFFF*FFFFFF*FFFFFFFFFFFFFFFFFFFFFFFFFFFFFFFFFFFFFFFFFFFFFF|FFFFFFFFFFFFFFFFFFFFFFFFFFFFFFFFFFFF*FF
FFFFFFFFFFFF*FFFFFF*FFFFFFFFF*FFFFFF*FFFFFFFFFFFFFFFFFFFFFFFFFFFFFFFFFFFFFFFFFFFFFF|**********************************FF*FF
FFFFFFFFFFFF*FFFFFF*FFFFFFFFF*FFFFFF*FFFFFFFFFFFFFFFFFFFFFFFFFFFFFFFFFFFFFFFFFFFFFFFFFFFFFFFFFFFFFFFFFFFFFFFFFFFFFFFF*FF*FF
FFFFFFFFFFFF*FFFFFF*FFFFFFFFF*FFFFFF*FFFFFFFFFFFFFFFFFFFFFFFFFFFFFFFFFFFFFFFFFFFFFFFFFFFFFFFFFFFFFFFFFFFFFFFFFFFFFFFF*FF*FF
FFFFFFFFFFFF*FFFFFF*FFFFFFFFF*FFFFFF*FFFFFFFFFFFFFFFFFFFFFFFFFFFFFFFFFFFFFFFFFFFFFFFFFFFFFFFFFFFFFFFFFFFFFFFFFFFFFFFF*FF*FF
FFFFFFFFFFFF*FFFFFF*FFFFFFFFF*FFFFFF*FFFFFFFFFFFFFFFFFFFFFFFFFFFFFFFFFFFFFFFFFFFFFFFFFFFFFFFFFFFFFFFFFFFFFFFFFFFFFFFF*FF*FF
FFFFFFFFFFFF*FFFFFF*FFFFFFFFF*FFFFFF*FFFFFFFFFFFFFFFFFFFFFFFFFFFFFFFFFFFFFFFFFFFFFFFFFFFFFFFFFFFFFFFFFFFFFFFFFFFFFFFF*FF*FF
FFFFFFFFFFFF*FFFFFF*FFFFFFFFF*FFFFFF*FFFFFFFFFFFFFFFFFFFFFFFFFFFFFFFFFFFFFFFFFFFFFFFFFFFFFFFFFFFFFFFFFFFFFFFFFFFFFFFF*FF*FF
FFFFFFFFFFFF*FFFFFF*FFFFFFFFF*FFFFFF*FFFFFFFFFFFFFFFFFFFFFFFFFFFFFFFFFFFFFFFFFFFFFFFFFFFFFFFFFFFFFFFFFFFFFFFFFFFFFFFF*FF*FF
*************FFFFFF*FFFFFFFFF*FFFFFF*FFFFFFFFFFFFFFFFFFFFFFFFFFFFFFFFFFFFFFFFFFFFFFFFFFFFFFFFFFFFFFFFFFFFFFFFFFFFFFFF*FF*FF
*FFFFFFFFFFFFFFFFFF*FFFFFFFFF*FFFFFF*FFFFFFFFFFFFFFFFFFFFFFFFFFFFF**************FFFFFFFFFFFFFFFFFFFFFFFFFFFFFFFFFFFFF*FF*FF
*FFFFFFFFFFFFFFFFFF*FFFFFFFFF*FFFFFF*FFFFFFFFFFFFFFFFFFFFFFFFFFFFF*FFFFFFFFFFFF*FFFFFFFFFFFFFFFFFFFFFFFFFFFFFFFFFFFFF*FF*FF
********************FFFFFFFFF*FFFFFF*FFFFFFFFFFFFFFFFFFFFFFFFFFFFF*FFFFFFFFFFFF*FFFFFFFFFFFFFFFFFFFFFFFFFFFFFFFFFFFFF*FF*FF
FFFFFFFFFFFFFFFFFFFFFFFFFFFFF*FFFFFF*FFFFFFFFFFFFFFFFFFFFFFFFFFFFF*FFFFFFFFFFFF*FFFFFFFFFFFFFFFFFFFFFFFFFFFFFFFFFFFFF*FF*FF
FFFFFFFFFFFFFFFFFFFFFFFFFFFFF*FFFFFF*FFFFFFFFFFF*******************FFFFF*FFFFFF*FFFFFFFFFFFFFFFFFFFFFFFFFFFFFFFFFFFFF*FF*FF
FFFFFFFFFFFFFFFFFFFFFFFFFFFFF*FFFFFF*FFFFFFFFFFF*FFFFFFFFFFFFFFFFF*FFFFF*FFFFFF*FFFFFFFFFFFFFFFFFFFFFFFFFFFFFFFFFFFFF*FF***
FFFFFFFFFFFFFFFFFFFFFFFFFFFFF*FFFFFF*FFFFFFFFFFF*FFFFFFFFFFFFFFFFF*FFFFF*FFFFFF*FFFFFFFFFFFFFFFFFFFFFFFFFFFFFFFFFFFFF*FFFF*
FFFFFFFFFFFFFFFFFFFFFFFFFFFFF*FFFFFF*FFFFFFFFFFF*FFFFFFFFFFFFFFFFF*FFFFF*FFFFFF*FFFFFFFFFFFFFFFFFFFFFFFFFFFFFFFFFFFFF*FFFF*
FFFFFFFFFFFFFFFFFFFFFFFFFFFFF*FFFFFF*FFFFFFFFFFF*FFFFFFFFFFFFFFFFF*FFFFF*FFFFFF*FFFFFFFFFFFFFFFFFFFFFFFFFFFFFFFFFFFFF*FFFF*
FFFFFFFFFFFFFFFFFFFFFFFFFFFFF*FFFFFF*FFFFFFFFFFF*FFFFFF******FFFFF*FFFFF*FFFFFF*FFFFFFFFFFFFFFFFFFFFFFFFFFFFFFFFFFFFF*FFFF*
FFFFFFFFFFFFFFFFFFFFFFFFFFFFF*FFFFFF*FFFFFFFFFFF*FFFFFF*FFFF*FFFFF*FFFFF*FFFFFF*FFFFFFFFFF****************************FFFF*
FFFFFFFFFFFFFFFFFFFFFFFFFFFFF*FFFFFF*FFFFFFFFFFF*FFFFFF*FFFF*FFFFF*FFFFF*FFFFFF*FFFFFFFFFF*FFFFFFFFFFFFFFFFFFFFFFFFFFFFFFF*
FFFFFFFFFFFFFFFFFFFFFFFFFFFFF*FFFFFF*FFFFFFFFFFF*FFFFFF*FFFF*FFFFF*FFFFF*FFFFFF*FFFFFFFFFF*FFFFFFFFFFFFFFFFFFFFFFFFFFFFFFF*
FFFFFFFFFFFFFFFFFFFFFFFFFFFFF*FFFFFF*FFFFFFFFFFF*FFFFFF*FFFF*FFFFF*FFFFF*FFFFFF*FFFFFFFFFF*FFFFFF**************************
FFFFFFFFFFFFFFFFFFFFFFFFFFFFF*FFFFFF*************FFFFFF*FFFF*FFFFF*FFFFF*FFFFFF************FFFFFF*FFFFFFFFFFFFFFFFFFFFFFFFF
FFFFFFFFFFFFFFFFFFFFFFFFFFFFF*FFFFFFFFFFFFFFFFFFFFFFFFF*FFFF*FFFFFFFFFFF*FFFFFFFFFFFFFFFFFFFFFFFF*FFFFFFFFFFFFFFFFFFFFFFFFF
FFFFFFFFFFFFFFFFFFFFFFFFFFFFF*FFFFFFFFFFFFFFFFFFFFFFFFF*FFFF*FFFFFFFFFFF*FFFFFFFFFFFFFFFFFFFFFFFF*FFFFFFFFFFFFFFFFFFFFFFFFF
FFFFFFFFFFFFFFFFFFFFFFFFFFFFF***************************FFFF*******************************FFFFFF*FFFFFFFFFFFFFFFFFFFFFFFFF
FFFFFFFFFFFFFFFFFFFFFFFFFFFFFFFFFFFFFFFFFFFFFFFFFFFFFFFFFFFFFFFFFFFFFFFFFFFFFFFFFFFFFFFFFF*FFFFFF*FFFFFFFFFFFFFFFFFFFFFFFFF
FFFFFFFFFFFFFFFFFFFFFFFFFFFFFFFFFFFFFFFFFFFFFFFFFFFFFFFFFFFFFFFFFFFFFFFFFFFFFFFFFFFFFFFFFF*FFFFFF*FFFFFFFFFFFFFFFFFFFFFFFFF
FFFFFFFFFFFFFFFFFFFFFFFFFFFFFFFFFFFFFFFFFFFFFFFFFFFFFFFFFFFFFFFFFFFFFFFFFFFFFFFFFFFFFFFFFF*FFFFFF*FFFFFFFFFFFFFFFFFFFFFFFFF
FFFFFFFFFFFFFFFFFFFFFFFFFFFFFFFFFFFFFFFFFFFFFFFFFFFFFFFFFFFFFFFFFFFFFFFFFFFFFFFFFFFFFFFFFF********FFFFFFFFFFFFFFFFFFFFFFFFF
FFFFFFFFFFFFFFFFFFFFFFFFFFFFFFFFFFFFFFFFFFFFFFFFFFFFFFFFFFFFFFFFFFFFFFFFFFFFFFFFFFFFFFFFFFFFFFFFFFFFFFFFFFFFFFFFFFFFFFFFFFF