FFFFFFFFFFFFFFFFFFFFFFFFFFFFFFFFFFFFFFFFFFFFFFFFFFFFFFFFFFFFFFFFFFFFFFFFFFFFFFFFFFFFFFFFFFFFFFFFFFFFFFFFFFFFF
FFFFFFFFFFFF*********************FFFFFFFFFFFFFFFFFFFFFFFFFFFFFFFFFFFFFFFFFFFFFFFFFFFFFFFFFFFFFFFFFFFFFFFFFFFF
FFFFFFFFFFFF*FFFFFFFIFFFFFFFFFFF*FFFFFFFFFFFFFFFFFFFFFFFFFFFFFFFFFFFFFFFFFFFFFFFFFFFFFFFFFFFFFFFFFFFFFFFFFFFF
FFFFFFFFFFFF*FFFFFFFFFFFFIFFFFFF*FFFFFFFFFFFFFFFFFFFFFFFFFFFFFFFFFFFFFFFFFFFFFFFFFFFFFFFFFFFFFFFFFFFFFFFFFFFF
FFFFFFFFFFFF*FFFFFF*******FFFFFF*FFFFFFFFFFFFFFFFFFFFFFFFFFFFFFFFFFFFFFFFFFFFFFFFFFFFFFFFFFFFFFFFFFFFFFFFFFFF
FFFFFFFFFFFF*FFFFFF*FFFFF*FFFFFF*FFFFFFFFFFFFFFFFFFFFFFFFFFFFFFFFFFFFFFFFFFFFFFFFFFFFFFFFFFFFFFFFFFFFFFFFFFFF
FFFFFFFFFFFF*FFFFFF*FFFFF*FFFFFF*FFFFFFFFFFFFFFFFFFFFFFFFFFFFFFFFFFFFFFFFFFFFFFFFFFFFFFFFFFFFFFFFFFFFFFFFFFFF
FFFFFFFFFFFF*FFFFFF*FFFFF*FFFFFF*FFFFFFFFFFFFFFFFFFFFFFFFFFFFFFFFFFFFFFFFFFFFFFFFFFFFFFFFFFFFFFFFFFFFFFFFFFFF
FFFFFFFFFFFF*F__FFF*FFFFF*FFFFFF*FFFFFFFFFFFFFFFFFFFFFFFFFFFFFFFFFFFFFFFFFFFFFFFFFFFFFFFFFFFFFFFFFFFFFFFFFFFF
FFFFFFFFFFFF*I__IFF*FFFFF*FFFFFF*FFFFFFFFFFFFFFFFFFFFFFFFFFFFFFFFFFFFFFFFFFFFFFFFFFFFFFFFFFFFFFFFFFFFFFFFFFFF
FFFFFFFFFFFF*FFFFFF*FFFFF*FFFFFF*FFFFFFFFFFFFFFFFFFFFFFFFFFFFFFFFFFFFFFFFFFFFFFFFFFFFFFFFFFFFFFFFFFFFFFFFFFFF
FFFFFFFFFFFF*FFFFFF*FFFFF*FFFFFF*FFFFFFFFFFFFFFFFFFFFFFFFFFFFFFFFFFFFFFFFFFFFFFFFFFFFFFFFFFFFFFFFFFFFFFFFFFFF
FFFFFFFFFFFF*FFFFFF*FFFFF*__FFFF*FFFFFFFFFFFFFFFFFFFFFFFFFFFFFFFFFFFFFFFFFFFF|*****************************FF
FFFFFFFFFFFF*FFFFFF*FFFFF*FFFFFF*FFFFFFFFFFFFFFFFFFFFFFFFFFFFFFFFFFFFFFFFFFFF|FFFFFFFFFFFFFFFFFFFFFFFFFFFF*FF
FFFFFFFFFFFF*FFFFFF*FFFFF*FFFFFF*FFFFFFFFFFFFFFFFFFFFFFFFFFFFFFFFFFFFFFFFFFFF|FFFFFFFFFFFFFFFFFFFFFFFFFFFF*FF
FFFFFFFFFFFF*FFFFFF*FFFFF*FFFF__*FFFFFFFFFFFFFFFFFFFFFFFFFFFFFFFFFFFFFFFFFFFF|**************************FF*FF
FFFFFFFFFFFF*FFFFFF*FFFFF*FFFFFF*FFFFFFFFFFFFFFFFFFFFFFFFFFFFFFFFFFFFFFFFFFFFFFFFFFFFFFFFFFFFFFFFFFFFFF*FF*FF
FFFFFFFFFFFF*FFFFFF*FFFFF*FFFFFF*FFFFFFFFFFFFFFFFFFFFFFFFFFFFFFFFFFFFFFFFFFFFFFFFFFFFFFFFFFFFFFFFFFFFFF*FF*FF
FFFFFFFFFFFF*FFFFFF*FFFFF*__FFFF*FFFFFFFFFFFFFFFFFFFFFFFFFFFFFFFFFFFFFFFFFFFFFFFFFFFFFFFFFFFFFFFFFFFFFF*FF*FF
FFFFFFFFFFFF*FFFFFF*FFFFF*FFFFFF*FFFFFFFFFFFFFFFFFFFFFFFFFFFFFFFFFFFFFFFFFFFFFFFFFFFFFFFFFFFFFFFFFFFFFF*FF*FF
FFFFFFFFFFFF*FFFFFF*FFFFF*FFFFFF*FFFFFFFFFFFFFFFFFFFFFFFFFFFFFFFFFFFFFFFFFFFFFFFFFFFFFFFFFFFFFFFFFFFFFF*FF*FF
FFFFFFFFFFFF*FFFFFF*FFFFF*FFFF__*FFFFFFFFFFFFFFFFFFFFFFFFFFFFFFFFFFFFFFFFFFFFFFFFFFFFFFFFFFFFFFFFFFFFFF*FF*FF
FFFFFFFFFFFF*FFFFFF*FFFFF*FFFFFF*FFFFFFFFFFFFFFFFFFFFFFFFFFFFFFFFFFFFFFFFFFFFFFFFFFFFFFFFFFFFFFFFFFFFFF*FF*FF
*************FFFFFF*FFFFF*FF__FF*FFFFFFFFFFFFFFFFFFFFFFFFFFFFFFFFFFFFFFFFFFFFFFFFFFFFFFFFFFFFFFFFFFFFFF*FF*FF
*FFFFFFFFFFFFFFFFFF*FFFFF*FFFFFF*FFFFFFFFFFFFFFFFFFFFFFFFFFF**************FFFFFFFFFFFFFFFFFFFFFFFFFFFFF*FF*FF
*FFFFFFFFFFFFFFFFFF*FFFFF*FFFFFF*FFFFFFFFFFFFFFFFFFFFFFFFFFF*FFFFFFFFFFFF*FFFFFFFFFFFFFFFFFFFFFFFFFFFFF*FF*FF
********************FFFFF*__FF__*FFFFFFFFFFFFFFFFFFFFFFFFFFF*FFFFFFFFFFFF*FFFFFFFFFFFFFFFFFFFFFFFFFFFFF*FF*FF
FFFFFFFFFFFFFFFFFFFFFFFFF*FFFFFF*FFFFFFFFFFFFFFFFFFFFFFFFFFF*FFFFFFFFFFFF*FFFFFFFFFFFFFFFFFFFFFFFFFFFFF*FF*FF
FFFFFFFFFFFFFFFFFFFFFFFFF*FFFFFF*FFFFFFFFF*******************FFIFI*FFFFFF*FFFFFFFFFFFFFFFFFFFFFFFFFFFFF*FF*FF
FFFFFFFFFFFFFFFFFFFFFFFFF*FFFFFF*FFFFFFFFF*IIIIIFFFFFFFFIIII*FIFFI*FFFFFF*FFFFFFFFFFFFFFFFFFFFFFFFFFFFF*FF***
FFFFFFFFFFFFFFFFFFFFFFFFF*FFFFFF*FFFFFFFFF*IIIIFFFFFFFFFFIII*FIFIF*FFFFFF*FFFFFFFFFFFFFFFFFFFFFFFFFFFFF*FFFF*
FFFFFFFFFFFFFFFFFFFFFFFFF*FFFFFF*FFFFFFFFF*IIFFFFIIIIIFFFFII*FIFIF*FFFFFF*FFFFFFFFFFFFFFFFFFFFFFFFFFFFF*FFFF*
FFFFFFFFFFFFFFFFFFFFFFFFF*FFFFFF*FFFFFFFFF*FFFFII******IFFFI*IFFIF*FFFFFF*FFFFFFFFFFFFFFFFFFFFFFFFFFFFF*F__F*
FFFFFFFFFFFFFFFFFFFFFFFFF*FFFFFF*FFFFFFFFF*FFFFFF*FFFF*FFFFF*IFIFF*FFFFFF*FFFFFFFFFFFFFFFFFFFFFFFFFFFFF*FFFF*
FFFFFFFFFFFFFFFFFFFFFFFFF*FFFFFF*FFFFFFFFF*FFFFFF*FFFF*FFFFF*IFIFF*FFFFFF*FFFFFFFFF*********************FFFF*
FFFFFFFFFFFFFFFFFFFFFFFFF*FFFFFF*FFFFFFFFF*FFFFFF*FFFF*FFF__*IFIFF*FFFFFF*FFFFFFFFF*FFFFFFFFFFFFFFFFFFFFFFFF*
FFFFFFFFFFFFFFFFFFFFFFFFF*FFFFFF*FFFFFFFFF*FFFFFF*FFFF*FFFFF*IFFIF*FFFFFF*FFFFFFFFF*FFFFFFFFFFFFFFFFFFFFFFFF*
FFFFFFFFFFFFFFFFFFFFFFFFF*FFFFFF*FFFFFFFFF*FFFFFF*FFFF*FFFFI*FIFIF*FFFFFF*FFFFFFFFF*FFFFFF*******************
FFFFFFFFFFFFFFFFFFFFFFFFF*FFFFFF***********FFFFFF*FFFF*FFFII*IFFFI*FFFFFF***********FFFFFF*FFFFFFFFFFFFFFFFFF
FFFFFFFFFFFFFFFFFFFFFFFFF*FFFFFFFIFFFFFFFFFFFFFFF*FFFF*FFFFIIFFFFF*FFFFFFFFFFFIFFFFFFFFFFF*FFFFFFFFFFFFFFFFFF
FFFFFFFFFFFFFFFFFFFFFFFFF*FFFFFFFFFFFFFIFFFFFFFFF*FFFF*FFFFFFFFFFF*FFFFFFFFFFFFFFFFFFFFFFF*FFFFFFFFFFFFFFFFFF
FFFFFFFFFFFFFFFFFFFFFFFFF*************************FFFF******************************FFFFFF*FFFFFFFFFFFFFFFFFF
FFFFFFFFFFFFFFFFFFFFFFFFFFFFFFFFFFFFFFFFFFFFFFFFFFFFFFFFFFFFFFFFFFFFFFFFFFFFFFFFFFF*FFFFFF*FFFFFFFFFFFFFFFFFF
FFFFFFFFFFFFFFFFFFFFFFFFFFFFFFFFFFFFFFFFFFFFFFFFFFFFFFFFFFFFFFFFFFFFFFFFFFFFFFFFFFF*FFFFFF*FFFFFFFFFFFFFFFFFF
FFFFFFFFFFFFFFFFFFFFFFFFFFFFFFFFFFFFFFFFFFFFFFFFFFFFFFFFFFFFFFFFFFFFFFFFFFFFFFFFFFF*FFFFFF*FFFFFFFFFFFFFFFFFF
FFFFFFFFFFFFFFFFFFFFFFFFFFFFFFFFFFFFFFFFFFFFFFFFFFFFFFFFFFFFFFFFFFFFFFFFFFFFFFFFFFF********FFFFFFFFFFFFFFFFFF
FFFFFFFFFFFFFFFFFFFFFFFFFFFFFFFFFFFFFFFFFFFFFFFFFFFFFFFFFFFFFFFFFFFFFFFFFFFFFFFFFFFFFFFFFFFFFFFFFFFFFFFFFFFFF