FFFFFFFFFFFFFFFFFFFFFFFFFFFFFFFFFFFFFFFFFFFFFFFFFFFFFFFFFFFFFFFFFFFFFFFFFFFFFFFFFFFFFFFFFFFFFFFFFFFFFFFFFFFFF
FFFFFFFFFFFF*********************FFFFFFFFFFFFFFFFFFFFFFFFFFFFFFFFFFFFFFFFFFFFFFFFFFFFFFFFFFFFFFFFFFFFFFFFFFFF
FFFFFFFFFFFF*FFFFFFFIFFFFFFFFFFF*FFFFFFFFFFFFFFFFFFFFFFFFFFFFFFFFFFFFFFFFFFFFFFFFFFFFFFFFFFFFFFFFFFFFFFFFFFFF
FFFFFFFFFFFF*FFFFFFFFFFFFIFFFFFF*FFFFFFFFFFFFFFFFFFFFFFFFFFFFFFFFFFFFFFFFFFFFFFFFFFFFFFFFFFFFFFFFFFFFFFFFFFFF
FFFFFFFFFFFF*FFFFFF*******FFFFFF*FFFFFFFFFFFFFFFFFFFFFFFFFFFFFFFFFFFFFFFFFFFFFFFFFFFFFFFFFFFFFFFFFFFFFFFFFFFF
FFFFFFFFFFFF*FFFFFF*FFFFF*FFFFFF*FFFFFFFFFFFFFFFFFFFFFFFFFFFFFFFFFFFFFFFFFFFFFFFFFFFFFFFFFFFFFFFFFFFFFFFFFFFF
FFFFFFFFFFFF*FFFFFF*FFFFF*FFFFFF*FFFFFFFFFFFFFFFFFFFFFFFFFFFFFFFFFFFFFFFFFFFFFFFFFFFFFFFFFFFFFFFFFFFFFFFFFFFF
FFFFFFFFFFFF*FFFFFF*FFFFF*FFFFFF*FFFFFFFFFFFFFFFFFFFFFFFFFFFFFFFFFFFFFFFFFFFFFFFFFFFFFFFFFFFFFFFFFFFFFFFFFFFF
FFFFFFFFFFFF*F__FFF*FFFFF*FFFFFF*FFFFFFFFFFFFFFFFFFFFFFFFFFFFFFFFFFFFFFFFFFFFFFFFFFFFFFFFFFFFFFFFFFFFFFFFFFFF
FFFFFFFFFFFF*I__IFF*FFFFF*FFFFFF*FFFFFFFFFFFFFFFFFFFFFFFFFFFFFFFFFFFFFFFFFFFFFFFFFFFFFFFFFFFFFFFFFFFFFFFFFFFF
FFFFFFFFFFFF*FFFFFF*FFFFF*FFFFFF*FFFFFFFFFFFFFFFFFFFFFFFFFFFFFFFFFFFFFFFFFFFFFFFFFFFFFFFFFFFFFFFFFFFFFFFFFFFF
FFFFFFFFFFFF*FFFFFF*FFFFF*FFFFFF*FFFFFFFFFFFFFFFFFFFFFFFFFFFFFFFFFFFFFFFFFFFFFFFFFFFFFFFFFFFFFFFFFFFFFFFFFFFF
FFFFFFFFFFFF*FFFFFF*FFFFF*__FFFF*FFFFFFFFFFFFFFFFFFFFFFFFFFFFFFFFFFFFFFFFFFFF|*****************************FF
FFFFFFFFFFFF*FFFFFF*FFFFF*FFFFFF*FFFFFFFFFFFFFFFFFFFFFFFFFFFFFFFFFFFFFFFFFFFF|FFFFFFFFFFFFFFFFFFFFFFFFFFFF*FF
FFFFFFFFFFFF*FFFFFF*FFFFF*FFFFFF*FFFFFFFFFFFFFFFFFFFFFFFFFFFFFFFFFFFFFFFFFFFF|FFFFFFFFFFFFFFFFFFFFFFFFFFFF*FF
FFFFFFFFFFFF*FFFFFF*FFFFF*FFFF__*FFFFFFFFFFFFFFFFFFFFFFFFFFFFFFFFFFFFFFFFFFFF|**************************FF*FF
FFFFFFFFFFFF*FFFFFF*FFFFF*FFFFFF*FFFFFFFFFFFFFFFFFFFFFFFFFFFFFFFFFFFFFFFFFFFFFFFFFFFFFFFFFFFFFFFFFFFFFF*FF*FF
FFFFFFFFFFFF*FFFFFF*FFFFF*FFFFFF*FFFFFFFFFFFFFFFFFFFFFFFFFFFFFFFFFFFFFFFFFFFFFFFFFFFFFFFFFFFFFFFFFFFFFF*FF*FF
FFFFFFFFFFFF*FFFFFF*FFFFF*__FFFF*FFFFFFFFFFFFFFFFFFFFFFFFFFFFFFFFFFFFFFFFFFFFFFFFFFFFFFFFFFFFFFFFFFFFFF*FF*FF
FFFFFFFFFFFF*FFFFFF*FFFFF*FFFFFF*FFFFFFFFFFFFFFFFFFFFFFFFFFFFFFFFFFFFFFFFFFFFFFFFFFFFFFFFFFFFFFFFFFFFFF*FF*FF
FFFFFFFFFFFF*FFFFFF*FFFFF*FFFFFF*FFFFFFFFFFFFFFFFFFFFFFFFFFFFFFFFFFFFFFFFFFFFFFFFFFFFFFFFFFFFFFFFFFFFFF*FF*FF
FFFFFFFFFFFF*FFFFFF*FFFFF*FFFF__*FFFFFFFFFFFFFFFFFFFFFFFFFFFFFFFFFFFFFFFFFFFFFFFFFFFFFFFFFFFFFFFFFFFFFF*FF*FF
FFFFFFFFFFFF*FFFFFF*FFFFF*FFFFFF*FFFFFFFFFFFFFFFFFFFFFFFFFFFFFFFFFFFFFFFFFFFFFFFFFFFFFFFFFFFFFFFFFFFFFF*FF*FF
*************FFFFFF*FFFFF*FF__FF*FFFFFFFFFFFFFFFFFFFFFFFFFFFFFFFFFFFFFFFFFFFFFFFFFFFFFFFFFFFFFFFFFFFFFF*FF*FF
*FFFFFFFFFFFFFFFFFF*FFFFF*FFFFFF*FFFFFFFFFFFFFFFFFFFFFFFFFFF**************FFFFFFFFFFFFFFFFFFFFFFFFFFFFF*FF*FF
*FFFFFFFFFFFFFFFFFF*FFFFF*FFFFFF*FFFFFFFFFFFFFFFFFFFFFFFFFFF*FFFFFFFFFFFF*FFFFFFFFFFFFFFFFFFFFFFFFFFFFF*FF*FF
********************FFFFF*__FF__*FFFFFFFFFFFFFFFFFFFFFFFFFFF*FFFFFIFFFFFF*FFFFFFFFFFFFFFFFFFFFFFFFFFFFF*FF*FF
FFFFFFFFFFFFFFFFFFFFFFFFF*FFFFFF*FFFFFFFFFFFFFFFFFFFFFFFFFFF*FFFFFIFFFFFF*FFFFFFFFFFFFFFFFFFFFFFFFFFFFF*FF*FF
FFFFFFFFFFFFFFFFFFFFFFFFF*FFFFFF*FFFFFFFFF*******************FFIFI*FFFFFF*FFFFFFFFFFFFFFFFFFFFFFFFFFFFF*FF*FF
FFFFFFFFFFFFFFFFFFFFFFFFF*FFFFFF*FFFFFFFFF*FIIIIIIIIIIIIIIII*FIFFI*FFFFFF*FFFFFFFFFFFFFFFFFFFFFFFFFFFFF*FF***
FFFFFFFFFFFFFFFFFFFFFFFFF*FF__FF*FFFFFFFFF*FFIIIIIIIIIIIIIII*FIFIF*__FFFF*FFFFFFFFFFFFFFFFFFFFFFFFFFFFF*FFFF*
FFFFFFFFFFFFFFFFFFFFFFFFF*FFFFFF*FFFFFFFFF*FFFIIIIIIIIIIIIII*FIFIF*FFFFFF*FFFFFFFFFFFFFFFFFFFFFFFFFFFFF*FFFF*
FFFFFFFFFFFFFFFFFFFFFFFFF*FFFFFF*FFFFFFFFF*FFFFFFFFFFFFFFIII*IFFIF*FFFFFF*FFFFFFFFFFFFFFFFFFFFFFFFFFFFF*F__F*
FFFFFFFFFFFFFFFFFFFFFFFFF*FFFFFI*FFFFFFFFF*FFFFFF******FFFFF*IFIFF*FFFFFF*FFFFFFFFFFFFFFFFFFFFFFFFFFFFF*FFFF*
FFFFFFFFFFFFFFFFFFFFFFFFF*FFFFIF*FFFFFFFFF*FFFFFF*FFFF*FFFFF*IFIFF*FF__FF*FFFFFFFFF*********************FFFF*
FFFFFFFFFFFFFFFFFFFFFFFFF*FFFFFF*FFFFFFFFF*FF__FF*FFFF*FFFFF*IFIFF*FFFFFF*FFFFFFFFF*FFFFFFFFFFFFFFFFFFFFFFFF*
FFFFFFFFFFFFFFFFFFFFFFFFF*FFFFFF*FFFFFFFFF*FFFFFF*FFFF*FFFFF*IFFIF*FFFFFF*FFFFFFFFF*FFFFFFFFFFFFFFFFFFFFFFFF*
FFFFFFFFFFFFFFFFFFFFFFFFF*FIFFFF*FFFFFFFFF*FFFFFF*FFFF*FFFFF*FIFIF*FFFFFF*FFFFFFFFF*FFFFFF*******************
FFFFFFFFFFFFFFFFFFFFFFFFF*IFFFFF***********FFFFFF*FFFF*FFFFF*IFFFI*FIFFIF***********FFFFFF*FFFFFFFFFFFFFFFFFF
FFFFFFFFFFFFFFFFFFFFFFFFF*FFFFFFFIFFFFFFFFFFFFFFF*FFFF*FFFFFFFFFFF*FFFFFFFFFFFFFFFFFFFFFFF*FFFFFFFFFFFFFFFFFF
FFFFFFFFFFFFFFFFFFFFFFFFF*FFFFFFFFFFFFFIFFFFFFFFF*FFFF*FFFFFFFFFFF*FFFFFFFFFFFFFFFFFFFFFFF*FFFFFFFFFFFFFFFFFF
FFFFFFFFFFFFFFFFFFFFFFFFF*************************FFFF******************************FFFFFF*FFFFFFFFFFFFFFFFFF
FFFFFFFFFFFFFFFFFFFFFFFFFFFFFFFFFFFFFFFFFFFFFFFFFFFFFFFFFFFFFFFFFFFFFFFFFFFFFFFFFFF*FFFFFF*FFFFFFFFFFFFFFFFFF
FFFFFFFFFFFFFFFFFFFFFFFFFFFFFFFFFFFFFFFFFFFFFFFFFFFFFFFFFFFFFFFFFFFFFFFFFFFFFFFFFFF*FFFFFF*FFFFFFFFFFFFFFFFFF
FFFFFFFFFFFFFFFFFFFFFFFFFFFFFFFFFFFFFFFFFFFFFFFFFFFFFFFFFFFFFFFFFFFFFFFFFFFFFFFFFFF*FFFFFF*FFFFFFFFFFFFFFFFFF
FFFFFFFFFFFFFFFFFFFFFFFFFFFFFFFFFFFFFFFFFFFFFFFFFFFFFFFFFFFFFFFFFFFFFFFFFFFFFFFFFFF********FFFFFFFFFFFFFFFFFF
FFFFFFFFFFFFFFFFFFFFFFFFFFFFFFFFFFFFFFFFFFFFFFFFFFFFFFFFFFFFFFFFFFFFFFFFFFFFFFFFFFFFFFFFFFFFFFFFFFFFFFFFFFFFF