FFFFFFFFFFFFFFFFFFFFFFFFFFFFFFFFFFFFFFFFFFFFFFFFFFFFFFFFFFFFFFFFFFFFFFFFFFFFFFFFFFFFFFFFFFFFFFFFFFFFFFFFFFFFF
FFFFFFFFFFFF*********************FFFFFFFFFFFFFFFFFFFFFFFFFFFFFFFFFFFFFFFFFFFFFFFFFFFFFFFFFFFFFFFFFFFFFFFFFFFF
FFFFFFFFFFFF*FFFFFFFIFFFFFFFFFFF*FFFFFFFFFFFFFFFFFFFFFFFFFFFFFFFFFFFFFFFFFFFFFFFFFFFFFFFFFFFFFFFFFFFFFFFFFFFF
FFFFFFFFFFFF*FFFFFFFFFFFFIFFFFFF*FFFFFFFFFFFFFFFFFFFFFFFFFFFFFFFFFFFFFFFFFFFFFFFFFFFFFFFFFFFFFFFFFFFFFFFFFFFF
FFFFFFFFFFFF*FF____*******FFFFFF*FFFFFFFFFFFFFFFFFFFFFFFFFFFFFFFFFFFFFFFFFFFFFFFFFFFFFFFFFFFFFFFFFFFFFFFFFFFF
FFFFFFFFFFFF*FFI__I*FFFFF*FFFFFF*FFFFFFFFFFFFFFFFFFFFFFFFFFFFFFFFFFFFFFFFFFFFFFFFFFFFFFFFFFFFFFFFFFFFFFFFFFFF
FFFFFFFFFFFF*FFFFFF*FFFFF*FFFFFF*FFFFFFFFFFFFFFFFFFFFFFFFFFFFFFFFFFFFFFFFFFFFFFFFFFFFFFFFFFFFFFFFFFFFFFFFFFFF
FFFFFFFFFFFF*FFFFFF*FFFFF*FFFFFF*FFFFFFFFFFFFFFFFFFFFFFFFFFFFFFFFFFFFFFFFFFFFFFFFFFFFFFFFFFFFFFFFFFFFFFFFFFFF
FFFFFFFFFFFF*F__FFF*FFFFF*FFFFFF*FFFFFFFFFFFFFFFFFFFFFFFFFFFFFFFFFFFFFFFFFFFFFFFFFFFFFFFFFFFFFFFFFFFFFFFFFFFF
FFFFFFFFFFFF*I__IFF*FFFFF*FFFFFF*FFFFFFFFFFFFFFFFFFFFFFFFFFFFFFFFFFFFFFFFFFFFFFFFFFFFFFFFFFFFFFFFFFFFFFFFFFFF
FFFFFFFFFFFF*FFFFFF*FFFFF*FFFFFF*FFFFFFFFFFFFFFFFFFFFFFFFFFFFFFFFFFFFFFFFFFFFFFFFFFFFFFFFFFFFFFFFFFFFFFFFFFFF
FFFFFFFFFFFF*FFFFFF*FFFFF*FFFFFF*FFFFFFFFFFFFFFFFFFFFFFFFFFFFFFFFFFFFFFFFFFFFFFFFFFFFFFFFFFFFFFFFFFFFFFFFFFFF
FFFFFFFFFFFF*FFFFFF*FFFFF*__FFFF*FFFFFFFFFFFFFFFFFFFFFFFFFFFFFFFFFFFFFFFFFFFF|*****************************FF
FFFFFFFFFFFF*FFFFFF*FFFFF*FFFFFF*FFFFFFFFFFFFFFFFFFFFFFFFFFFFFFFFFFFFFFFFFFFF|FFFFFFFFFFFFFFFFIFFFFFFFFFFFF*FF
FFFFFFFFFFFF*FFFFFF*FFFFF*FFFFFF*FFFFFFFFFFFFFFFFFFFFFFFFFFFFFFFFFFFFFFFFFFFF|FFFFFFFFFFFIFFFFFFFFFFFFFFFF*FF
FFFFFFFFFFFF*FFFFFF*FFFFF*FFFF__*FFFFFFFFFFFFFFFFFFFFFFFFFFFFFFFFFFFFFFFFFFFF|**************************IF*FF
FFFFFFFFFFFF*FFFFFF*FFFFF*FFFFFF*FFFFFFFFFFFFFFFFFFFFFFFFFFFFFFFFFFFFFFFFFFFFFFFFFFFFFFFFFFFFFFFFFFFFFF*FF*FF
FFFFFFFFFFFF*FFFFFF*FFFFF*FFFFFF*FFFFFFFFFFFFFFFFFFFFFFFFFFFFFFFFFFFFFFFFFFFFFFFFFFFFFFFFFFFFFFFFFFFFFF*F_*FF
FFFFFFFFFFFF*FFFFFF*FFFFF*__FFFF*FFFFFFFFFFFFFFFFFFFFFFFFFFFFFFFFFFFFFFFFFFFFFFFFFFFFFFFFFFFFFFFFFFFFFF*FF*FF
FFFFFFFFFFFF*FFFFFF*FFFFF*FFFFFF*FFFFFFFFFFFFFFFFFFFFFFFFFFFFFFFFFFFFFFFFFFFFFFFFFFFFFFFFFFFFFFFFFFFFFF*IF*FF
FFFFFFFFFFFF*FFFFFF*FFFFF*FFFFFF*FFFFFFFFFFFFFFFFFFFFFFFFFFFFFFFFFFFFFFFFFFFFFFFFFFFFFFFFFFFFFFFFFFFFFF*FF*FF
FFFFFFFFFFFF*FFFFFF*FFFFF*FFFF__*FFFFFFFFFFFFFFFFFFFFFFFFFFFFFFFFFFFFFFFFFFFFFFFFFFFFFFFFFFFFFFFFFFFFFF*FI*FF
FFFFFFFFFFFF*FFFFFF*FFFFF*FFFFFF*FFFFFFFFFFFFFFFFFFFFFFFFFFFFFFFFFFFFFFFFFFFFFFFFFFFFFFFFFFFFFFFFFFFFFF*FF*FF
*************FFFFFF*FFFFF*FF__FF*FFFFFFFFFFFFFFFFFFFFFFFFFFFFFFFFFFFFFFFFFFFFFFFFFFFFFFFFFFFFFFFFFFFFFF*_F*FF
*FFFFFFFFFFFFFFFFFF*FFFFF*FFFFFF*FFFFFFFFFFFFFFFFFFFFFFFFFFF**************FFFFFFFFFFFFFFFFFFFFFFFFFFFFF*FF*FF
*FFFFFFFFFFFFFFFFFF*FFFFF*FFFFFF*FFFFFFFFFFFFFFFFFFFFFFFFFFF*FFFFFFFFFFFF*FFFFFFFFFFFFFFFFFFFFFFFFFFFFF*FI*FF
********************FFFFF*__FF__*FFFFFFFFFFFFFFFFFFFFFFFFFFF*FFFFFIFFFFFF*FFFFFFFFFFFFFFFFFFFFFFFFFFFFF*FF*FF
FFFFFFFFFFFFFFFFFFFFFFFFF*FFFFFF*FFFFFFFFFFFFFFFFFFFFFFFFFFF*FFFFFIFFFFFF*FFFFFFFFFFFFFFFFFFFFFFFFFFFFF*IF*FF
FFFFFFFFFFFFFFFFFFFFFFFFF*FFFFFF*FFFFFFFFF*******************FFIFI*FFFFFF*FFFFFFFFFFFFFFFFFFFFFFFFFFFFF*FF*FF
FFFFFFFFFFFFFFFFFFFFFFFFF*FFFFFF*FFFFFFFFF*FIIIIIIIIIIIIIIII*FIFFI*FFFFFF*FFFFFFFFFFFFFFFFFFFFFFFFFFFFF*FF***
FFFFFFFFFFFFFFFFFFFFFFFFF*FF__FF*FFFFFFFFF*FFIIIIIIIIIIIIIII*FIFIF*__FFFF*FFFFFFFFFFFFFFFFFFFFFFFFFFFFF*FFFF*
FFFFFFFFFFFFFFFFFFFFFFFFF*FFFFFF*FFFFFFFFF*FFFIIIIIIIIIIIIII*FIFIF*FFFFFF*FFFFFFFFFFFFFFFFFFFFFFFFFFFFF*FFFF*
FFFFFFFFFFFFFFFFFFFFFFFFF*FFFFFF*FFFFFFFFF*FFFFFFFFFFFFFFIII*IFFIF*FFFFFF*FFFFFFFFFFFFFFFFFFFFFFFFFFFFF*F__F*
FFFFFFFFFFFFFFFFFFFFFFFFF*FFFFFI*FFFFFFFFF*FF____******FFFFF*IFIFF*FFFFFF*FFFFFFFFFFFFFFFFFFFFFFFFFFFFF*FFFF*
FFFFFFFFFFFFFFFFFFFFFFFFF*FFFFIF*FFFFFFFFF*FFFFFF*FFFF*__FFF*IFIFF*FF__FF*FFFFFFFFF*********************FFFF*
FFFFFFFFFFFFFFFFFFFFFFFFF*FFFIFF*FFFFFFFFF*FF____*FFFF*FFFFI*IFIFF*FFFFFF*FFFFFFFFF*FFFFFFFFFFFFFFFFFFFFFFFF*
FFFFFFFFFFFFFFFFFFFFFFFFF*FFFFFF*FFFFFFFFF*FFFFFF*FFFF*FFF__*IFFIF*FFF___*FFFFFFFFF*FFFFFFFFFFFFFFFFFFFFFFFF*
FFFFFFFFFFFFFFFFFFFFFFFFF*FIFFFF*FFFFFFFFF*FFFFFF*FFFF*FFFFF*FIFIF*FFFFFF*FFFFFFFFF*FFFFFF*******************
FFFFFFFFFFFFFFFFFFFFFFFFF*IFFFFF***********FFFFFF*FFFF*FF___*IFFFI*FIFFIF***********FFFFFF*FFFFFFFFFFFFFFFFFF
FFFFFFFFFFFFFFFFFFFFFFFFF*FFFFFFFIFFFFFFFFFFFFFFF*FFFF*FFFFFFFFFFF*FFFFFFFFFFFFFFFIFFFFFFF*FFFFFFFFFFFFFFFFFF
FFFFFFFFFFFFFFFFFFFFFFFFF*FFFFFFFFFFFFFIFFFFFFFFF*FFFF*FFFFFFFFFFF*FFFFFFFFIFFFFFFFFFFFFFF*FFFFFFFFFFFFFFFFFF
FFFFFFFFFFFFFFFFFFFFFFFFF*************************FFFF******************************FFFFFF*FFFFFFFFFFFFFFFFFF
FFFFFFFFFFFFFFFFFFFFFFFFFFFFFFFFFFFFFFFFFFFFFFFFFFFFFFFFFFFFFFFFFFFFFFFFFFFFFFFFFFF*FFFFFF*FFFFFFFFFFFFFFFFFF
FFFFFFFFFFFFFFFFFFFFFFFFFFFFFFFFFFFFFFFFFFFFFFFFFFFFFFFFFFFFFFFFFFFFFFFFFFFFFFFFFFF*FFFFFF*FFFFFFFFFFFFFFFFFF
FFFFFFFFFFFFFFFFFFFFFFFFFFFFFFFFFFFFFFFFFFFFFFFFFFFFFFFFFFFFFFFFFFFFFFFFFFFFFFFFFFF*FFFFFF*FFFFFFFFFFFFFFFFFF
FFFFFFFFFFFFFFFFFFFFFFFFFFFFFFFFFFFFFFFFFFFFFFFFFFFFFFFFFFFFFFFFFFFFFFFFFFFFFFFFFFF********FFFFFFFFFFFFFFFFFF
FFFFFFFFFFFFFFFFFFFFFFFFFFFFFFFFFFFFFFFFFFFFFFFFFFFFFFFFFFFFFFFFFFFFFFFFFFFFFFFFFFFFFFFFFFFFFFFFFFFFFFFFFFFFF