FFFFFFFFFFFFFFFFFFFFFFFFFFFFFFFFFFFFFFFFFFFFFFFFFFFFFFFFFFFFFFFFFFFFFFFFFFFFFFFFFFFFFFFFFFFFFFFFFFFFFFFFFFFFF
FFFFFFFFFFFF*********************FFFFFFFFFFFFFFFFFFFFFFFFFFFFFFFFFFFFFFFFFFFFFFFFFFFFFFFFFFFFFFFFFFFFFFFFFFFF
FFFFFFFFFFFF*FFFFFFFIFFFFFFFFFFF*FFFFFFFFFFFFFFFFFFFFFFFFFFFFFFFFFFFFFFFFFFFFFFFFFFFFFFFFFFFFFFFFFFFFFFFFFFFF
FFFFFFFFFFFF*FFFFFFFFFFFFIFFFFFF*FFFFFFFFFFFFFFFFFFFFFFFFFFFFFFFFFFFFFFFFFFFFFFFFFFFFFFFFFFFFFFFFFFFFFFFFFFFF
FFFFFFFFFFFF*FF____*******FFFFFF*FFFFFFFFFFFFFFFFFFFFFFFFFFFFFFFFFFFFFFFFFFFFFFFFFFFFFFFFFFFFFFFFFFFFFFFFFFFF
FFFFFFFFFFFF*FFI__I*FFFFF*FFFFFF*FFFFFFFFFFFFFFFFFFFFFFFFFFFFFFFFFFFFFFFFFFFFFFFFFFFFFFFFFFFFFFFFFFFFFFFFFFFF
FFFFFFFFFFFF*FFFFFF*FFFFF*FFFFFF*FFFFFFFFFFFFFFFFFFFFFFFFFFFFFFFFFFFFFFFFFFFFFFFFFFFFFFFFFFFFFFFFFFFFFFFFFFFF
FFFFFFFFFFFF*FFFFFF*FFFFF*FFFFFF*FFFFFFFFFFFFFFFFFFFFFFFFFFFFFFFFFFFFFFFFFFFFFFFFFFFFFFFFFFFFFFFFFFFFFFFFFFFF
FFFFFFFFFFFF*F__FFF*FFFFF*FFFFFF*FFFFFFFFFFFFFFFFFFFFFFFFFFFFFFFFFFFFFFFFFFFFFFFFFFFFFFFFFFFFFFFFFFFFFFFFFFFF
FFFFFFFFFFFF*I__IFF*FFFFF*FFFFFF*FFFFFFFFFFFFFFFFFFFFFFFFFFFFFFFFFFFFFFFFFFFFFFFFFFFFFFFFFFFFFFFFFFFFFFFFFFFF
FFFFFFFFFFFF*FFFFFF*FFFFF*FFFFFF*FFFFFFFFFFFFFFFFFFFFFFFFFFFFFFFFFFFFFFFFFFFFFFFFFFFFFFFFFFFFFFFFFFFFFFFFFFFF
FFFFFFFFFFFF*FFFFFF*FFFFF*FFFFFF*FFFFFFFFFFFFFFFFFFFFFFFFFFFFFFFFFFFFFFFFFFFFFFFFFFFFFFFFFFFFFFFFFFFFFFFFFFFF
FFFFFFFFFFFF*FFFFFF*FFFFF*___FFF*FFFFFFFFFFFFFFFFFFFFFFFFFFFFFFFFFFFFFFFFFFFF|*****************************FF
FFFFFFFFFFFF*FFFFFF*FFFFF*FFFFFF*FFFFFFFFFFFFFFFFFFFFFFFFFFFFFFFFFFFFFFFFFFFF|FFFFFFFFFFFFFFFFIFFFFFFFFFFF*FF
FFFFFFFFFFFF*FFFFFF*FFFFF*FFFFFF*FFFFFFFFFFFFFFFFFFFFFFFFFFFFFFFFFFFFFFFFFFFF|FFFFFFFFFFFIFFFFFFFIFFFIFFFF*FF
FFFFFFFFFFFF*FFFFFF*FFFFF*FFF___*FFFFFFFFFFFFFFFFFFFFFFFFFFFFFFFFFFFFFFFFFFFF|**************************IF*FF
FFFFFFFFFFFF*FFFFFF*FFFFF*FFFFFF*FFFFFFFFFFFFFFFFFFFFFFFFFFFFFFFFFFFFFFFFFFFFFFFFFFFFFFFFFFFFFFFFFFFFFF*FF*FF
FFFFFFFFFFFF*FFFFFF*FFFFF*FFFFFF*FFFFFFFFFFFFFFFFFFFFFFFFFFFFFFFFFFFFFFFFFFFFFFFFFFFFFFFFFFFFFFFFFFFFFF*F_*FF
FFFFFFFFFFFF*FFFFFF*FFFFF*___FFF*FFFFFFFFFFFFFFFFFFFFFFFFFFFFFFFFFFFFFFFFFFFFFFFFFFFFFFFFFFFFFFFFFFFFFF*FF*FF
FFFFFFFFFFFF*FFFFFF*FFFFF*FFFFFF*FFFFFFFFFFFFFFFFFFFFFFFFFFFFFFFFFFFFFFFFFFFFFFFFFFFFFFFFFFFFFFFFFFFFFF*IF*FF
FFFFFFFFFFFF*FFFFFF*FFFFF*FFFFFF*FFFFFFFFFFFFFFFFFFFFFFFFFFFFFFFFFFFFFFFFFFFFFFFFFFFFFFFFFFFFFFFFFFFFFF*FF*FF
FFFFFFFFFFFF*FFFFFF*FFFFF*FFF___*FFFFFFFFFFFFFFFFFFFFFFFFFFFFFFFFFFFFFFFFFFFFFFFFFFFFFFFFFFFFFFFFFFFFFF*FI*FF
FFFFFFFFFFFF*FFFFFF*FFFFF*FFFFFF*FFFFFFFFFFFFFFFFFFFFFFFFFFFFFFFFFFFFFFFFFFFFFFFFFFFFFFFFFFFFFFFFFFFFFF*FF*FF
*************FFFFFF*FFFFF*F____F*FFFFFFFFFFFFFFFFFFFFFFFFFFFFFFFFFFFFFFFFFFFFFFFFFFFFFFFFFFFFFFFFFFFFFF*_F*FF
*FFFFFFFFFFFFFFFFFF*FFFFF*FFFFFF*FFFFFFFFFFFFFFFFFFFFFFFFFFF**************FFFFFFFFFFFFFFFFFFFFFFFFFFFFF*FF*FF
*FFFFFFFFFFFFFFFFFF*FFFFF*FFFFFF*FFFFFFFFFFFFFFFFFFFFFFFFFFF*FFFFFFFFFFFF*FFFFFFFFFFFFFFFFFFFFFFFFFFFFF*FI*FF
********************FFFFF*__FF__*FFFFFFFFFFFFFFFFFFFFFFFFFFF*FFFFFIFFFFFF*FFFFFFFFFFFFFFFFFFFFFFFFFFFFF*FF*FF
FFFFFFFFFFFFFFFFFFFFFFFFF*FFFFFF*FFFFFFFFFFFFFFFFFFFFFFFFFFF*FFFFFIFFFFFF*FFFFFFFFFFFFFFFFFFFFFFFFFFFFF*IF*FF
FFFFFFFFFFFFFFFFFFFFFFFFF*FFFFFF*FFFFFFFFF*******************FIFIF*FFFFFF*FFFFFFFFFFFFFFFFFFFFFFFFFFFFF*FF*FF
FFFFFFFFFFFFFFFFFFFFFFFFF*FFFFFF*FFFFFFFFF*FIIIIIIIIIIIIIIII*FIFFI*FFFFFF*FFFFFFFFFFFFFFFFFFFFFFFFFFFFF*FF***
FFFFFFFFFFFFFFFFFFFFFFFFF*F____F*FFFFFFFFF*FFIIIIIIIIIIIIIII*FFIFI*__FFFF*FFFFFFFFFFFFFFFFFFFFFFFFFFFFF*FFFF*
FFFFFFFFFFFFFFFFFFFFFFFFF*FFFFFF*FFFFFFFFF*FFFIIIIIIIIIIIIII*FIFFI*FFFFFF*FFFFFFFFFFFFFFFFFFFFFFFFFFFFF*FFFF*
FFFFFFFFFFFFFFFFFFFFFFFFF*FFFFFF*FFFFFFFFF*FFFFFFFFFFFFFFIII*FIFIF*FFFFFF*FFFFFFFFFFFFFFFFFFFFFFFFFFFFF*F__F*
FFFFFFFFFFFFFFFFFFFFFFFFF*FFFFFI*FFFFFFFFF*FF____******FFFFF*IFFIF*FFFFFF*FFFFFFFFFFFFFFFFFFFFFFFFFFFFF*FFFF*
FFFFFFFFFFFFFFFFFFFFFFFFF*FFFFIF*FFFFFFFFF*FFFFFF*FFFF*___FF*IFIFF*FF__FF*FFFFFFFFF*********************FFFF*
FFFFFFFFFFFFFFFFFFFFFFFFF*FFFIFF*FFFFFFFFF*FF____*FFFF*FFFFI*IFIFF*FFFFFF*FFFFFFFFF*FFFFFFFFFFFFFFFFFFFFFFFF*
FFFFFFFFFFFFFFFFFFFFFFFFF*FFFFFF*FFFFFFFFF*FFFFFF*FFFF*FF___*IFFIF*FFF___*FFFFFFFFF*FFFFFFFFFFFFFFFFFFFFFFFF*
FFFFFFFFFFFFFFFFFFFFFFFFF*FIFFFF*FFFFFFFFF*FFFFFF*FFFF*FFFFF*FIFIF*FFFFFF*FFFFFFFFF*FFFFFF*******************
FFFFFFFFFFFFFFFFFFFFFFFFF*IFFFFF***********FFFFFF*FFFF*FF___*IFFFI*FIFFIF***********___FFF*FFFFFFFFFFFFFFFFFF
FFFFFFFFFFFFFFFFFFFFFFFFF*FFFFFFFIFFFFFFFFFFFFFFF*FFFF*FFFFFFFFFFF*FFFFFFFFFFFIFFFFFFIFFFF*FFFFFFFFFFFFFFFFFF
FFFFFFFFFFFFFFFFFFFFFFFFF*FFFFFFFFFFFFFIFFFFFFFFF*FFFF*FFFFFFFFFFF*FFFFFFIFFFFFFFFIFFFFFFF*FFFFFFFFFFFFFFFFFF
FFFFFFFFFFFFFFFFFFFFFFFFF*************************FFFF******************************FFFFFF*FFFFFFFFFFFFFFFFFF
FFFFFFFFFFFFFFFFFFFFFFFFFFFFFFFFFFFFFFFFFFFFFFFFFFFFFFFFFFFFFFFFFFFFFFFFFFFFFFFFFFF*FFFFFF*FFFFFFFFFFFFFFFFFF
FFFFFFFFFFFFFFFFFFFFFFFFFFFFFFFFFFFFFFFFFFFFFFFFFFFFFFFFFFFFFFFFFFFFFFFFFFFFFFFFFFF*FFFFFF*FFFFFFFFFFFFFFFFFF
FFFFFFFFFFFFFFFFFFFFFFFFFFFFFFFFFFFFFFFFFFFFFFFFFFFFFFFFFFFFFFFFFFFFFFFFFFFFFFFFFFF*FFFFFF*FFFFFFFFFFFFFFFFFF
FFFFFFFFFFFFFFFFFFFFFFFFFFFFFFFFFFFFFFFFFFFFFFFFFFFFFFFFFFFFFFFFFFFFFFFFFFFFFFFFFFF********FFFFFFFFFFFFFFFFFF
FFFFFFFFFFFFFFFFFFFFFFFFFFFFFFFFFFFFFFFFFFFFFFFFFFFFFFFFFFFFFFFFFFFFFFFFFFFFFFFFFFFFFFFFFFFFFFFFFFFFFFFFFFFFF