
            *************************
            *                       *
			*                       *
            *      ***********      *
            *      *         *      *
            *      *         *      *
            *      *         *      *
            *      *         *      *
            *      *         *      *
            *      *         *      *
            *      *         *      *                                                    
            *      *         *      *                                              |*************************************            
            *      *         *      *                                              |                                    *
            *      *         *      *                                              |                                    *
            *      *         *      *                                              |**********************************  *         
            *      *         *      *                                                                                *  *
            *      *         *      *                                                                                *  *
            *      *         *      *                                                                                *  *
            *      *         *      *                                                                                *  *                                                    
            *      *         *      *                                                                                *  *
            *      *         *      *                                                                                *  *
            *      *         *      *                                                                                *  *
*************      *         *      *                                                                                *  *
*                  *         *      *                             **************                                     *  *
*                  *         *      *                             *            *                                     *  *
********************         *      *                             *            *                                     *  *
                             *      *                             *            *                                     *  *
							 *      *           *******************     *      *                                     *  *
							 *      *           *                 *     *      *                                     *  ***
							 *      *           *                 *     *      *                                     *    *
							 *      *           *                 *     *      *                                     *    *
							 *      *           *                 *     *      *                                     *    *
							 *      *           *      ******     *     *      *                                     *    *
							 *      *           *      *    *     *     *      *          ****************************    *
							 *      *           *      *    *     *     *      *          *                               *
							 *      *           *      *    *     *     *      *          *                               *
							 *      *           *      *    *     *     *      *          *      **************************                                     
							 *      *************      *    *     *     *      ************      *
							 *                         *    *           *                        *
                             *                         *    *           *                        *
                             ***************************	*******************************      *         
							                                                              *      *         
																						  *      *         
																						  *      *         
																						  ********




